1110N11000000000000000000000000000000000
E110000000000000000000000000000000000000
110C000000000000000000000000000000000000
1001C00N00000000000000000000000000000000
100C000N00000000000000000000000000000000
100CN11N00000000000000000000000000000000
10N1N111N0000000000000000000000000000000
100C01N000000000000000000000000000000000
100C010P00000000000000000000000000000000
0C1CC10CC0000000000000000000000000000000
000C010000000000000000000000000000000000
000C010000000000000000000000000000000000
000C110000000000000000000000000000000000
0000100000000000000000000000000000000000
0000000000000000000000000000000000000000
0000000000000000000000000000000000000000
0000000000000000000000000000000000000000
0000000000000000000000000000000000000000
0000000000000000000000000000000000000000
0000000000000000000000000000000000000000
0000000000000000000000000000000000000000
0000000000000000000000000000000000000000
