1111111
1PCCE01
1000N01
1111111
