1111111111111111111
110101111P100000001
1100000010101101101
11011101101N1000101
1001C100001010C0101
1101010110101000101
100N000110001101101
1111010110100000001
1111011110111110111
1C0000000E0000000C1
1110111110111101111
1000000010110101111
1011011000110000001
1N10001010110101011
1010C010100001C1001
1010001010110111011
101101101010000N011
100000001C111101011
1111111111111111111
