1111111111111111111111111111111111111111
1100000111100000000000000000011111000011
1N01100000001011111111111101000000000001
101111000000101N000000000101111000111101
10100110111110101110011101010010C0100101
1010010001001010101001C10101001000111101
1011110C01001010101111010001111000000001
10111111111110101000E1000111111111111101
10100000000000001C0001010000000000000101
1010111111111101110001111111111111110101
101010000000000000000000000000000001C101
10101N11110C0111111111111110C01111010101
101C100000000000000000000000000000010101
1010111111111111111000111011111111110101
1010000000000000101000C10000000000000101
1011111111111110001P00010101111111111101
10000000011110001011110101010010C0111101
10111100010010101C1001010101001000100101
1010010C01001010111001110101111101100101
101111000111101N000000000101000000111101
10000000000N1011111111111101000000011001
1100001111100000000000000000011110000011
1111111111111111111111111111111111111111
