111111111111111111111111111111111111111111
10000001000000000001N000011111000000111111
10C11100011000110C00011101N000000000000011
100000N10000000000N10111010110001100011011
111100111001110011110111000110C0110C011001
111111111111111111110000000000000000000001
111100111001110011110111000110C0110C011001
100000000000000000010111010110001100011011
110011000110001100110111010000000000000011
100011000110001100010000011111100001111111
110000000000000000111000111000000000000001
1P0000000000000000000000000010101010100E01
110000000000000000111000111000000000000001
100011000110001100010000011111100001111111
110011000110001100110111010000000000000011
100000000000000000010111010110001100011011
111100111001110011110111000110C0110C011001
111111111111111111110000000000000000000001
111100111001110011110111000110001100011001
1N000001N000000000010111010110C0110C011001
10C11100011000110C000111010000000000000N11
100000010000000000010000N11111000000111111
111111111111111111111111111111111111111111
