1111111111111111111111111
1100011101101111100110001
1000001000000011000010C01
1000000010100001011000001
10C0001010101001000000001
1000000000101001011000111
1000001010001001000000011
110111101110C001101000001
1100000000001001001000001
1000000000111001101011001
1C01100000010001000000001
100010111101P0010C0000001
1110101000000001000000011
1000100011011011101110111
1C10111010000000000000C01
1000000010000010101010001
1111111111111110111011111
1011000000010100000001101
1E0001111000C000111100001
1111111111111111111111111
