111111111111111111111111111111
10000001C100110001100011110011
101101110100000000000000100001
1C1000000101111111111100000001
1111101100000000000000000000C1
101000010101100000011100000001
10100000010100111001C100100001
100011001100011100000001110011
1100C11P000100C001010001111111
110011001100011100000000000101
1100000000000011100100001001C1
111100000001100000010111100101
10010011100000000000001C100001
100000000010001001010010100101
1101011110000010010100101001C1
100000000011111001010010100101
1C0101111000001001010000001111
100001000000000000011100000011
111101C011110011110111001110E1
111111111111111111111111111111
