11111111111111111111111111111111111
10000111110000100111110011101100011
101000000000001000C0010000000111011
10101100011110111001000000000000011
10100000000010001001010110110001011
1C10111110101100100100010C010101001
1010000010001C011101000110110001C01
11110110101010011100010100000001001
10000C10000011001100110001110111011
11100110011000001000C10000010100001
10000000000010011000011101010101111
10010100111011000000000001000100001
10000000100010000111111101000001101
1111001110000001000000100C000100101
10000001111010011000001000010110101
1101110110001011C010000010110110101
10010100100C101E0010001000000100101
10C1011010P010000000101111110101101
100000001000110011101000000001010C1
11111111111111111111111111111111111
