1111111
1PCCE01
10000N1
1111111
