1111111111111111111111111111111111111111111111111111111
1101011010111001010011011001001001110010010011011101101
1001000010000011011010001011101100100110111011011001111
1000000010000000000000000000001000000010010000000000001
1000000000000000000000000000000000000000000000000000001
1111100011011101110111000101000110011101110011000100101
1111100111001101100011001101100111011000110111011100111
1100100000000001000001011101110100001000110001001101111
1100000000000000000000000000000000000000000000000000001
1000001000111010101110111010000010111011001110111011101
1111011000111011100110110011101110110011001110111001101
1110011100101011101110111011101110110011101000001001101
10000000C00000C0P00000100010000000000000001010100000001
1000000000000000000000111011100101000100111011100000111
1000000000000000000000101000100111011100101010100000101
10CE000000000000000000000000000100010000001000100000001
1111111111111111111111111111111111111111111111111111111
